1111111111111111111111111111111111
110000000000000C00000C000100000101
11101111001000001010010001000101M1
1P11000010101010001001000100000011
10100100101010100010010M0100010101
1010010010101010001001000100000001
1010010010101010001001000100010101
1010001010101010001001000100010101
100001000C00C0000000000000010000C1
1111111111111111101111111111111111
1E0000000000000C00000C000100000001
1110111100100000101001000100010101
1011000010101010001001000100000001
1010010010101010001001000100010101
1010010010101010001001000100000001
1010010010101010001001000100010101
1010001010101010001001000100010101
100001000C00C0000000000000010000C1
1111111111111111111111111111111111